TILEMAP
90 9 					-- Size of tile map in tiles
32 64 				-- Tile size & block size
images/TileSheet1.png		-- Tilesheet1
8 8					-- Number of tiles in tilesheet1
18,1,1,1,1,17,11,16,12,11,17,1,5,5,8,9,7,8,7,6,9,8,6,6,7,8,6,6,8,9,18,3,1,1,11,11,11,12,11,17,17,12,11,16,12,16,12,11,12,17,17,16,11,16,11,19,11,3,11,19,1,1,1,11,12,11,12,11,8,18,1,1,1,1,1,1,1,1,1,1,1,1,1,1,1,1,1,1,1,1,
17,1,3,1,1,6,6,7,5,7,18,15,17,1,5,7,9,6,8,9,6,7,9,18,3,1,17,16,12,17,17,16,16,11,17,1,1,6,7,8,9,6,8,7,7,6,6,6,6,6,6,6,6,7,7,18,17,1,7,18,16,16,12,17,1,7,9,7,7,18,1,1,1,1,1,1,1,1,1,1,1,1,1,1,1,1,1,1,1,1,
17,1,3,1,1,7,7,9,8,5,6,8,18,11,17,14,16,12,1,11,17,16,12,17,15,15,6,9,6,7,6,18,17,11,17,11,11,8,7,7,8,6,7,8,9,6,6,6,6,6,6,18,16,11,12,1,17,15,5,7,6,6,6,18,15,17,1,12,11,18,11,11,11,11,11,11,11,11,11,11,11,11,11,11,11,11,11,11,11,11,
17,1,4,1,1,17,11,11,12,11,11,1,1,11,3,1,12,17,11,19,1,3,1,1,1,1,1,1,3,1,1,1,11,12,17,1,1,17,16,19,3,1,1,1,1,3,11,12,11,19,16,12,11,1,17,11,12,16,11,17,3,1,8,9,6,18,3,1,8,7,6,6,6,6,6,6,6,6,6,18,11,1,1,0,0,4,1,1,1,6,
17,1,3,1,1,17,16,16,11,17,17,11,11,18,3,1,5,8,9,18,16,12,16,11,11,1,11,11,12,12,16,11,17,11,17,3,1,6,7,18,16,16,11,1,3,11,17,11,11,5,7,9,18,1,9,6,6,6,6,18,16,11,17,16,11,17,11,12,17,11,17,12,11,16,12,16,11,12,12,17,17,12,16,20,11,16,11,12,11,5,
18,11,11,13,15,17,1,7,8,8,9,6,5,18,14,1,6,7,6,7,5,6,9,8,18,1,5,8,9,9,8,8,18,1,17,11,11,17,11,6,7,9,18,3,1,6,6,9,6,6,6,6,18,14,14,6,9,6,6,9,6,6,6,6,6,6,6,6,6,6,6,6,6,6,6,6,6,6,6,9,6,6,6,9,7,7,9,7,7,7,
18,3,1,11,12,17,15,17,1,8,6,9,8,6,18,1,5,6,9,6,6,8,6,5,18,1,8,8,7,6,9,7,18,11,17,11,16,3,1,7,6,7,18,3,1,6,9,6,6,18,1,1,1,1,1,1,1,1,1,1,1,1,1,1,1,1,1,1,1,1,1,1,1,1,1,1,1,1,1,1,1,1,1,1,1,1,1,1,1,1,
18,3,1,7,7,7,5,18,15,17,17,16,16,12,17,14,17,16,11,17,17,16,12,17,3,1,1,9,7,9,9,5,8,7,6,18,17,3,1,6,9,6,18,3,1,1,6,6,6,18,1,1,1,1,1,1,1,1,1,1,1,1,1,1,1,1,1,1,1,1,1,1,1,1,1,1,1,1,1,1,1,1,1,1,1,1,1,1,1,1,
18,14,14,8,5,9,6,5,7,7,9,6,6,8,5,6,6,6,9,6,6,5,6,18,12,11,15,5,6,7,5,7,6,6,6,7,18,14,14,17,17,13,17,11,15,11,6,6,6,18,1,1,1,1,1,1,1,1,1,1,1,1,1,1,1,1,1,1,1,1,1,1,1,1,1,1,1,1,1,1,1,1,1,1,1,1,1,1,1,1
